CCCMMMMMMMMMMMMMMMMMMMWWWSBBSWMMMMMB
CRCMMMMMMMMMTTTTTTTTMMWWWSBBSWMMMMMB
CCCMMMMCCCGGGBBBBBBTGGGGGGGGGGMMMMMM
MTMMMMMCCCDDDDDDBBBHHGHHGCCCGGGGTTTM
MTMMMMMHHDWWWWWDGGGHHCHHGCCCGGHHBBTB
MTMMMMMHHDWWWWWDHGGHHCHHGGTGGBBBBBTB
MTMMMMMGGDWWWWWDGGGGGGGGHGTGGHHGGGTB
MTMMMMMGGDWWWWWBBBCCCCCGGCCCCCGHCCCB
MTMGHGGCCDWWWWWBCCCCCCCGHCCCCCGHCCCB
GGGHGHGCCDWWWWWBCBCCCCCGGCCCCCGHGBCB
DDDDDDDGGDWWWWWBCBGGGGGGGGTHGGHHHBCB
DDDDDDDGGDWWWWWBCBGHHHGGGGCCCHGGHBCB
DDDDDDDGGDWWWWWBCBGGHHGGGGCCCGGGGBCB
DDDDDDDPCDWWWWWBCBGGGGGGGGGGCGGGGGCB
DDDDDDDCCDWWWWWBCBWWWWWWWWBWCBWWWBCB
WWWWWWWWWWBWWWWBCBWWWWWWWWBWCBWWWDCB
WWWWWWWWWWBWWWWBCBWWWWWWWWWWWWWWWDCB
WWWWWWWWSWBWWWWBCBWWWWWWWWWWWWWWWDCB
WWWWWWWWWWBWWWWBCBBBBBBBBBBDDDDDDDCB
WWWWWWWSSWBWWWWBCBBGGCCCCCGDDDDDDDCB
WWWWWWWWWWBWWWWBCCCGGCCCCCGCCCCCCCCB
WWWWWWWWWWBWWWWBBBBGGCCCCCGBBBBBBBBB
WWWWWWWWWWBWWWWWWWWWWSSSSSWWWWWWWWWW
WWWWWWWWSWBBWWWWWWWWWWWWWWWWWWWWWWWW
WWWWWWWWWWWBWWWWWWWWWWWWWWWWWWWWWWWW
WWWWWWSWWWWBWWWWWWWWWWWWWWWWWWWWSSWW
WWWWWWWWWWWBWWWSSSWWWWWWWWWWWWWWWWWW
WWWWWWWWWWWBWWWWWWWWWWWWWSSWWWWWWWWW
WWWWWWWCCCCSWWWWWWWWWWWWWWWWWWWWWWWW
WWWWWWWCCCCSWWWWWWWWWWWWWWWWWWWWWWWW
WWWWWWWCCCCSWWWWWWWSMSWWWWWWWWWWWWWW
WWWWWWWCCCCSWSSWWWWWSWWWWWWWWWWWWWWW
WWWWWWWWWWWWWWSWWWWWWWWWSWWWWWWWWWWW
WWWWWWWWWWWWWWWWWWWWWWWWWWWWWWSSWWWW
WWWWWWWWWWWWWWWWWSSSWWWWWWWWWWWWWWWW
WWWWWWWWWWWWWWWWWWSWWWWWWWWWWWWWWWWW
